#
000000000000
000002000000
000002000000
000002000000
000022200000
000022200000
000222220000
002222222000
022222222200
022222222200
222222222220
222222222220
222222222220
022222222200
002222222000
000000000000
#
000000000000
000000000000
000000000000
000000000000
000002000000
000002000000
000022200000
000222220000
002222222000
002222222000
022222222200
022222222200
022222222200
002222222000
000000000000
000000000000
#
000000000000
000000000000
000000000000
000000000000
000000000000
000000000000
000002000000
000022200000
000222220000
000222220000
002222222000
002222222000
002222222000
000000000000
000000000000
000000000000
#
000000000000
000000000000
000000000000
000000000000
000000000000
000000000000
000000000000
000002000000
000622260000
006162616000
000622260000
000222220000
000055500000
000000000000
000000000000
000000000000
